NO textures/wall1.xpm
SO textures/wall2.xpm
WE textures/wall3.xpm
EA textures/wall4.xpm

F 136,204,238
C 118,159,221

111111111111111111111111111
100000000000110000000000001
100000000000000000010000001
100000000000000001000000001
100000000000000001000000001
100000000000000001000000001
100000000000000001000000001
100000000000000001000000001
100000000000000001000000001
100000000000000001000000001
100000000000000001000000001
100000000000000001000000001
100000000000000010000000001
100000000N00000100000110111
111111111111111111111111111
