NO textures/painting_north.xpm
SO textures/painting_south.xpm
WE textures/painting_west.xpm
EA textures/painting_east.xpm

F 77,92,53
C 163,208,230

11111111111111111111111111111
10000000001100000000000000001
10110000011100000001111011111
11111111110000000000000000011111
        10110000011100000000000111111
        1000000000110000011111111111
11111111111111011100000010001
11110111111111011101010010001
11000000110101011100000010001
10000000000000001100000010001
10000000000000001100010000001
11000000110101000000000000001
11110111110101000000000000001
10000000001100000100000010001
10000000000000000000000011111
10000000111100010000N011
100000001  100110101110111
10000000111110000001 10100111
11111111111111111111 11111111
