NO textures/wall1.xpm
SO textures/wall2.xpm
WE textures/wall3.xpm
EA textures/wall4.xpm

F 184,113,39
C 163,208,230

111111111111111111111111111111
100000000011000000000000000011
111100000111000000011111111111
111111111100000000000000011111
111100000111000000000111111111
111111111001100000111011110011
111101111111110111000000100011
111101111111110111010100100011
110000001101010111000000100011
10000000000000001100000010001111
100000000000000011000100000011
110000001101010000000000000011
111101111101010000000000000011
100000000011000001000000100011
100000000000000000000000010011
100000001111110010000N00001011
100000001   10011011111000011
10000000111111000001 101000011
11111111111111111111 111111111