NO textures/painting_north.xpm
SO textures/painting_south.xpm
WE textures/painting_west.xpm
EA textures/painting_east.xpm

F 136,204,238
C 105, 74, 72

11111111111111111111111111
10000000000011000000000001
10111101111011011110111101
10111101111011011110111101
10111101111011011110111101
10000000000000000000000001
10111101011111111010111101
10000000000011000010000001
11111101111011011110111111
11111101000000000010111111
111111010111cc111010111111
10000000010000001000000001
11111101011111111010111111
11111101000000000010111111
11111101011111111010111111
10000000000011000000000001
10111101111011011110111101
1000110000000E000000110001
11101101c11111111c10110111
10000001000011000010000001
10111111111011011111111101
10000000000000000000000001
11111111111111111111111111