NO textures/painting_north.xpm
SO textures/painting_south.xpm
WE textures/painting_west.xpm
EA textures/painting_east.xpm

F 184,113,39
C 51,198,227

1 1 1 1 1 1 1 1 1 1 1 1 1 1
1 1 0 0 0 1 0 0 0 0 0 0 0 1
1 1 0 0 0 0 0 1 1 1 1 1 0 1
1 1 0 0 0 1 0 0 1 0 0 0 0 1
1 1 0 0 0 0 0 1 1 0 0 0 0 1
1 1 0 0 0 1 0 0 1 0 1 1 0 1
1 1 0 0 0 0 0 1 1 0 0 1 0 1
1 1 0 0 0 1 0 0 1 0 1 1 0 1
1 1 0 0 0 0 0 1 1 0 0 0 0 1
1 1 0 0 0 1 0 0 1 0 0 0 0 1
1 1 0 0 0 0 0 1 1 1 1 1 0 1
1 1 0 0 0 1 0 0 0 0 0 0 0 1
1 1 0 0 0 0 0 1 1 0 0 0 0 1
1 1 0 0 0 1 0 0 5 0 0 0 0 1 1 1 1 1 1 1 1
1 1 0 0 0 0 0 1 1 1 0 0 0 0 0 0 0 0 0 0 1
1 1 0 0 0 1 0 0 1 1 1 1 1 1 1 0 0 0 0 0 1
1 1 0 0 0 0 0 1 1 0 0 0 0 1 1 0 0 0 0 0 1
1 1 0 0 0 1 0 0 1 0 0 0 0 1 1 0 0 0 0 0 1
1 1 0 0 0 0 0 1 1 0 0 0 0 1 1 0 0 0 0 0 1
1 1 0 0 0 1 0 0 1 0 0 0 0 1 1 0 0 0 0 0 1
1 1 1 1 0 1 0 1 1 1 1 1 0 1 1 0 0 0 0 0 1
1 1 0 0 0 1 0 0 0 0 0 0 0 0 0 0 0 0 0 0 1
1 1 0 0 0 1 0 1 1 1 1 1 0 1 1 1 1 1 1 1 1
1 1 0 1 1 1 0 1 1 1 0 0 0 1
1 1 0 1 0 1 0 1 0 1 0 0 0 1
1 1 0 1 0 0 0 0 0 1 0 0 0 1
1 1 0 1 0 0 0 1 0 1 1 1 1 1
1 1 0 0 0 1 0 0 0 1
1 1 0 0 0 0 0 0 1 1
1 1 1 0 0 0 0 0 1
1 1 0 0 0 0 0 0 1
1 1 0 0 0 0 0 0 1
1 1 1 1 1 1 1 1 1
