NO textures/new1.xpm
SO textures/new2.xpm
WE textures/new3.xpm
EA textures/new4.xpm

F 184,113,39
C 51,198,227

11111111111111
11000100000001
11000011111011
11000100010001
11000110000001
11000101011001
11000110010101
11000100000101
11000100000001
11000011111001
11000100000001
110N0011100001
11000100000011
11000011110001111111
11000111100000000001
11000101111111111101
11000011100000110001
11000101100000110001
11000011100000110001
11000101100000110001
11101011111101000111
11000000000000000001
11000101111111111111
111111111
