NO textures/north_rock.xpm
SO textures/south_rock.xpm
WE textures/west_rock.xpm
EA textures/east_rock.xpm
F 255,0,0
C 0,0,255
111111111111
101000010001
101000010001
101001110001
101000010001
100000010001
100000000001
111110000001
100010000001
110000000001
1000100000N1
111111111111
